Język niemiecki 

laufen - gelaufen (s)
sein - gewesen (s)
gehen - gegangen (s)
washen - gewashen (h)
bleiben - gebleiben (s)
finden - gefunden (h)
holen - geholt (h)
kommen - gekommen (s)
schlafen - geschlafen (h)
reparieren - gerepariert (h)
trinken - getrinken (h)
kochen - gekocht (h)
singen - gesungen (h)
tanzen - getanzt (h)
nechmen - genommen (h)
sprechen - gesprochen (h)

Werden - geworden (s) (Zostać)  
Bleiben - Gebleiben (s) (pozostać)
schreiben - geschrieben (h) (pisać)
Heifen - Geholfen (h) (Pomóc)
verstehen - verstanden (h) (rozumieć)
wissen - gewusst (h) (Wiedzieć)
sehen - gesehen (h) (widzieć) 
verlieren - Verloren (h) (stracić)
haben - gehabt (h) (Mieć)
fallen - gefallen (s) (Upaść)
sitzen - gesessen (h) (Siedzieć)
sagen - gesagt (h) (Powiedzieć)
kennen - gekannt (h) (znać)
umziehen - Umgezaken (s) (Przeprowadzać się)
spielen - gespielt (h) (Grać)
lachen - gelacht (h) (Śmiać się)

